1 1 1 1 1 1 1 1 1 1 1 1
1 0 0 0 0 0 0 0 0 0 3 1
1 1 1 0 1 1 1 0 1 1 1 1
1 0 1 0 1 0 1 0 1 0 1 1
1 1 1 0 1 1 1 3 1 0 1 1
1 1 0 0 1 0 1 0 1 1 1 1
1 0 0 0 2 0 1 0 0 0 0 1
1 0 0 0 0 1 1 1 1 1 1 1
1 0 0 0 2 0 1 0 2 3 2 1
1 0 0 5 2 0 1 0 2 3 2 1
1 6 6 0 0 0 1 0 2 2 2 1
1 0 0 0 0 0 6 0 0 0 0 1
1 0 0 0 0 0 0 0 0 0 0 1
1 0 0 0 6 6 6 0 0 0 0 1
1 0 0 0 6 6 6 0 0 0 0 1
1 1 1 1 1 1 1 1 1 1 1 1

